NCF	hello@ncf.kz
UNIpage	education@unipage.net
ITEC	info@itec.com.ru
WORLDABROAD	info@world-abroad.com
CAMPUS	info@campusca.ru
WG Agency	annaletovastudy@gmail.com
EDUCATION INDEX	info@educationindex.ru
ACADEM LUX	info@academlux.com
FIVE LANDS	info@fivelands-education.com
COLLEGE COACH	helpdesk@getintocollege.com
EFIIE	info@efiie.com
H&C	info@hceducationconsulting.com
Solomon Admissions	info@solomonadmissions.com
William Clarence	info@williamclarence.com
UNYP	admissions@unyp.cz
IVYSUMMIT	info@ivysummit.com
GUAC	info@universityconsultancy.de
Skill Matrix	info@skillmatrix.kz
GC Education	gceducation24@gmail.com
Smart Test Prep	founders@smartestprep.com
IQanat	ceo@iqanat.kz
Impact Admissions	info@impact-admissions.com
IDP IELTS KZ	info1@ielts.kz
Ivy League KZ	info@ivy-usa.com
CAU	nfo@centralasian.uz
World UZ	info@world.uz
GoStudy	info@gostudy.cz
Universe	info@universegroup.uz
ES Group	info@esgroup.uz
StudyIN	info@studyin.university
Go Study 	info@go-study.uz
All TERRA	contact@allterra.ru
BC	bc-tashkent@britishcouncil.uz
Touran Study	info@touranstudy.uz
ABC World	chashma98@mail.ru
ADAM	info@gouni.uz
Asia Consult	asia_consalt_centr@mail.ru
Baltic Center	uzbekistan@baltic-centr.eu
BCC	bcctash@bcc.com.uz
PAVA Education 	info@pavaedu.com
